Ivar
4
*****************
*  ++-------++ 0*
* +++++++++     *
*+++++vvvvv ++++*
*---+>1SSSS<+---*
*---+>SSRSS<+---*
*---->SRoRS<+---*
*---+>SSRSS<+---*
*---+>SSSSS<+---*
*+++++^^^^^+++++*
* +++++++++++++ *
*3 ++-------++ 2*
*****************
